...##....#
#..##..#..
#.....##..
...##.....
......##..
..#.#.....
.........#
.......#..
.......#.#
....#.....